# Datatypes
AdsAddress	KEYWORD1
AdsGain	KEYWORD1
AdsSampleSpeed	KEYWORD1
ComparatorModeConfig	KEYWORD1
ComparatorPolarityConfig	KEYWORD1
ComparatorLatchingConfig	KEYWORD1
ComparatorAssertConfig	KEYWORD1
MuxConfig	KEYWORD1
Ads1115Plus	KEYWORD1

# Methods and functions
begin	KEYWORD2
readADC_singleEnded	KEYWORD2
readChannelRaw	KEYWORD2
readChannelMillivolts	KEYWORD2
readADC_Differential_0_1	KEYWORD2
readADC_Differential_2_3	KEYWORD2
readDifferentialRaw01	KEYWORD2
readDifferentialRaw03	KEYWORD2
readDifferentialRaw13	KEYWORD2
readDifferentialRaw23	KEYWORD2
readDifferentialMillivolts01	KEYWORD2
readDifferentialMillivolts03	KEYWORD2
readDifferentialMillivolts13	KEYWORD2
readDifferentialMillivolts23	KEYWORD2
readRawOnMux	KEYWORD2
readMillivoltsOnMux	KEYWORD2
startComparator_SingleEnded	KEYWORD2
startComparatorModeOnMux	KEYWORD2
startComparatorMode	KEYWORD2
startComparatorMode01	KEYWORD2
startComparatorMode03	KEYWORD2
startComparatorMode13	KEYWORD2
startComparatorMode23	KEYWORD2
startContinousConversionMode	KEYWORD2
startContinousConversionMode01	KEYWORD2
startContinousConversionMode03	KEYWORD2
startContinousConversionMode13	KEYWORD2
startContinousConversionMode23	KEYWORD2
startContinousConversionModeOnMux	KEYWORD2
getLastConversionResults	KEYWORD2
getLastConversionMillivolts	KEYWORD2
setComparatorLatching	KEYWORD2
getComparatorLatching	KEYWORD2
setComparatorMode	KEYWORD2
getComparatorMode	KEYWORD2
setComparatorPolarity	KEYWORD2
getComparatorPolarity	KEYWORD2
setComparatorAssert	KEYWORD2
getComparatorAssert	KEYWORD2
clearComparatorLatch	KEYWORD2
setGain	KEYWORD2
getGain	KEYWORD2
setSampleSpeed	KEYWORD2
getSampleSpeed	KEYWORD2
millivoltsPerRawValue	KEYWORD2
delayForChannelReading	KEYWORD2
rawValueToMillivolts	KEYWORD2
millivoltsToRawValue	KEYWORD2

# Constants
GAIN_TWOTHIRDS	LITERAL1
GAIN_ONE	LITERAL1
GAIN_TWO	LITERAL1
GAIN_FOUR	LITERAL1
GAIN_EIGHT	LITERAL1
GAIN_SIXTEEN	LITERAL1